{
  "level1": [497, 152, 496, 304, 380, 459, 480,  90, 151, 371, 404, 156, 489,
    446,  64],
  "level2": [154, 269, 259, 284, 473, 396,  66, 264,  10, 293, 146, 329, 233,
    449, 313, 201, 127, 381,  63, 465, 132, 223,  13,  14, 304,  78,
    125, 337, 470, 440],
  "level3": [254, 477, 428, 189,  94, 332, 390, 384, 304, 308, 229, 345, 306,
  157, 147, 456, 177, 346, 426, 478, 340, 371, 140, 151, 235,  27,
  311, 450, 221, 241,  29, 280, 295, 104, 275, 188, 407, 271, 296,
  284,  28,  55, 192, 488,  34, 156, 470, 231, 360, 150, 292, 211,
  207, 103, 101, 386, 277, 248, 167, 359, 268, 106, 377, 410, 372,
  351, 138, 281, 358, 498, 206, 419,  86, 322, 234, 285, 172, 300,
  446, 258, 431, 335, 187, 307, 385, 262, 240, 153, 343,  67, 442,
  361, 406, 398, 333, 347,  47, 245, 117, 325, 132, 484, 228,  93,
   48, 416, 199, 159,  37, 148, 298,  95, 291,  53,  13, 222, 290,
   24, 445, 409, 170, 339, 313,  11, 373, 465, 149,  97,  58, 376,
  279, 471, 495, 316, 165,  66, 429,  62,  73,  82, 323,  75, 135,
  401, 391, 414, 131, 415,  57, 370,  14, 265, 301, 475, 435, 267,
   68, 142, 408, 399, 461, 310, 302,  85,  98,   4,  70, 364, 273,
  482, 226, 356, 441, 452,  81, 137,   9, 178, 318, 451, 378, 342],
  "level4": [ 48, 349, 116, 169, 278, 382, 217, 157, 434, 314, 338, 368, 378,
  472, 175, 263, 111, 499, 219, 186, 144,  98,  13, 251, 419, 201,
   22, 398, 198, 322, 235, 179,   1, 246, 439,  51, 248,  67, 162,
   95,  20, 402, 134, 187, 131, 218,  81,  41, 287, 341, 277, 103,
  329, 392,   4, 406, 426, 118, 188,  57, 415,  89, 427, 327, 317,
  256,  33,  70, 330, 185,  88,  31, 215, 227, 358, 181, 290, 123,
  497, 396,  40, 453, 249, 177, 143, 170, 142,  24, 306, 285, 468,
  293, 447, 182, 299, 463, 383,  83,  11,  37, 213,  75,  65, 154,
  411,  90, 196, 254, 404, 363, 454, 384, 438, 259,  61, 260, 461,
    0, 284, 261, 373, 372, 482,  16, 492, 395, 199, 312, 253, 171,
  335,  62, 271, 394, 267, 364, 183, 210,  85, 408, 291,  96, 375,
  448, 331, 421,  19, 315,  49, 206,  29, 189, 126, 266, 292,  99,
  212, 400, 436, 297, 119, 428, 140,   3, 155, 460, 361, 264, 423,
  399, 336, 490, 129, 377,  26, 339, 484, 125, 365, 435, 356, 288,
  495, 305, 476, 135,  21,   5, 236,  54, 205, 413, 147, 100, 220,
  286,  36, 471, 397, 128,  91, 494,  71, 242, 237, 403, 332,  30,
  153, 489, 496,  94, 244, 437, 362, 320, 194, 316, 483, 420, 120,
   87, 138, 477, 148, 273,  55, 480, 376,  93, 430, 190, 228, 407,
  367, 416,   9, 487, 204, 449, 121,  43, 410, 149, 301, 231, 357,
  133, 343, 354,  66, 234,  32, 280, 105,   7,  74,  34,  52, 172,
  298, 221, 401, 150, 337, 470, 200,  15, 112, 109, 485,  58, 452,
  474, 243,  39, 191, 355,  45, 386, 451,  86, 414, 208, 158, 374,
  333, 173, 351, 431, 127, 478, 203, 469, 296,  10,  64, 270, 441,
  268,  17, 418, 325, 156, 283, 145, 479, 313, 429, 442, 319, 274,
  230, 174, 245, 224, 146, 318, 180, 310, 113, 166, 110,  47, 424,
  311, 202, 473, 163, 262, 457, 417, 326, 122, 132, 258, 216, 380,
  117, 106, 444, 498, 381, 115, 108,  28, 107,   6, 475,  68, 307,
  353, 391, 167, 226, 433, 456, 282, 141, 328, 250, 130, 104, 102,
  446, 458,  78, 389, 101,  56, 255,  92, 370, 491, 440, 321, 359,
  151, 385,  50, 387,  35, 139, 152, 360, 369, 184, 159, 350, 462,
  412, 346, 366, 425, 241, 344, 269, 295, 281, 443, 309, 168, 388,
   25,  23,  14,  46, 214, 455, 209, 238, 176, 252,  97, 464, 222,
  124, 393, 193, 232,   2, 308, 239,  42, 300, 114, 390, 289,  59,
  247, 334,  63,   8, 467,  77, 225, 486,  38, 347, 160, 233,  84,
  197, 294, 240,  73, 345,  18,  12,  27, 405, 302,  79, 136, 257,
  272, 229, 342,  69, 450, 275, 348, 276, 422, 459, 165, 481, 192,
   44, 265, 164, 303, 466, 352, 323,  76, 371,  80,  60, 465, 409,
  161, 493,  53, 279, 137, 223, 195, 211, 379, 432, 178, 304,  82,
  207, 488, 445,  72, 324, 340]
}

